1111111111111111
100E00000001C001
1011111111011101
100C000000000001
1111101111111111
1000000000000001
1110111111011101
1000000000000001
1011111111111111
100C001P00000001
1111111111111111
