1111111111111111
100E00000001C001
1011111111011101
100C000000000001
1111101111111111
100000000z000001
11101111110111001
1000000000000001
1011110111111101
100C0000P0000C01
1111111111111111
