11111111111111111111
1C0000CCCC00000V00C1
1100101000000001C011
1P001E100000000CCC01
11111111111111111111